17 12
12 12 12 6 8 8 8 8 8 8 8 8 8 6 12 12 12
12 12 12 6 8 5 5 8 8 8 5 5 8 6 12 12 12
12 12 12 6 3 3 3 3 3 3 3 3 3 6 12 12 12
12 12 12 6 0 16 17 0 0 0 0 0 4 6 12 12 12
12 12 12 6 0 0 0 0 0 0 0 0 9 6 12 12 12
12 12 12 6 0 0 0 0 0 0 0 0 0 6 12 12 12
12 12 12 6 0 0 0 0 0 0 0 0 0 6 12 12 12
12 12 12 6 0 0 0 0 0 0 0 0 0 6 12 12 12
12 12 12 6 0 0 0 0 0 0 0 0 0 6 12 12 12
12 12 12 6 0 0 0 0 0 0 0 0 0 6 12 12 12
12 12 12 6 0 0 0 0 10 0 0 0 0 6 12 12 12
12 12 12 6 7 7 7 7 11 7 7 7 7 6 12 12 12