11 11
4 1 3 3 1 1 1 3 3 1 4
4 2 2 2 2 2 2 2 2 2 4
4 0 0 0 0 0 0 0 0 0 4
4 0 0 0 0 0 0 0 0 0 4
4 0 0 0 0 0 0 0 0 0 4
4 0 0 0 0 0 0 0 0 0 4
4 0 0 0 0 0 0 0 0 0 4
4 0 0 0 0 0 0 0 0 0 4
4 0 0 0 0 0 0 0 0 0 4
4 0 0 0 0 6 0 0 0 0 4
5 5 5 5 5 7 5 5 5 5 5