17 12
22 20 20 20 20 20 20 23 20 20 1 1 1 20 20 20 24
20 2 3 4 20 21 20 21 1 21 1 0 9 9 10 20 20
21 5 6 7 21 20 20 21 1 1 11 12 13 13 14 15 20
21 1 8 21 21 22 21 20 21 1 1 21 21 20 1 20 1
20 21 20 20 1 1 21 1 1 1 24 20 1 1 20 20 20
21 23 21 1 1 1 1 1 21 20 20 20 20 20 20 22 20
20 20 20 20 20 20 20 20 20 20 20 20 20 20 20 20 20
16 16 18 16 16 16 16 16 16 16 16 16 19 16 19 16 19
16 16 16 18 16 16 16 16 16 16 16 19 16 16 19 19 16
18 16 16 16 16 16 16 16 16 16 16 16 17 17 17 17 17
16 16 18 16 18 16 16 16 16 16 16 17 17 17 17 17 17
18 16 16 16 16 16 16 16 16 17 17 17 17 17 17 17 17