17 12
7 1 3 3 3 3 3 3 3 3 3 3 3 3 3 1 7
7 1 3 3 3 3 3 3 3 3 3 3 3 3 3 1 7
7 1 2 2 2 2 2 2 2 2 2 2 2 2 2 1 7
7 1 0 0 0 0 0 0 0 0 0 0 0 0 4 1 7
7 1 0 0 0 0 0 0 0 0 0 0 0 0 6 1 7
7 1 0 0 0 0 0 0 0 0 0 0 0 0 0 1 7
7 1 0 0 0 0 0 0 0 0 0 0 0 0 0 1 7
7 1 0 0 0 0 0 0 0 0 0 0 0 0 0 1 7
7 1 0 0 0 0 0 0 0 0 0 0 0 0 0 1 7
7 1 0 5 0 0 0 0 0 0 0 0 0 0 0 1 7
7 1 1 1 1 1 1 1 1 1 1 1 1 1 1 1 7
7 7 7 7 7 7 7 7 7 7 7 7 7 7 7 7 7