17 12
4 4 4 4 8 10 10 10 10 10 10 10 6 4 4 4 4
4 4 4 8 10 1 2 2 1 1 2 2 10 6 4 4 4
4 4 8 10 3 1 11 13 1 1 15 16 1 10 6 4 4
4 4 10 0 0 0 12 14 0 0 17 18 0 0 10 4 4
4 4 10 0 0 0 0 0 0 0 19 20 0 0 10 4 4
4 4 10 0 0 0 0 0 0 0 0 0 0 0 10 4 4
4 4 10 0 0 0 0 0 0 0 0 0 0 0 10 4 4
4 4 10 0 0 0 0 0 0 0 0 0 0 0 10 4 4
4 4 10 0 0 0 0 0 0 0 0 0 0 0 10 4 4
4 4 9 10 0 0 0 0 0 0 0 0 0 10 7 4 4
4 4 4 9 10 0 0 0 0 0 0 0 10 7 4 4 4
4 4 4 4 9 10 10 10 10 10 10 10 7 4 4 4 4