17 12
0 0 0 0 0 0 0 0 0 0 0 0 0 0 0 0 0
0 1 1 1 1 0 0 0 0 0 0 0 0 1 1 3 2
3 0 0 0 0 1 2 2 0 1 1 0 1 1 0 2 2
0 10 11 12 2 0 1 2 3 1 1 0 1 0 2 0 0
0 13 14 15 0 1 1 0 0 0 1 1 0 3 1 0 0
2 0 7 9 2 2 2 2 0 0 1 0 2 2 1 1 0
0 0 4 2 1 1 1 2 1 1 1 0 0 0 0 1 0
0 0 2 0 0 0 0 2 0 1 10 11 12 0 0 1 0
0 2 0 1 2 2 2 0 2 2 13 14 15 0 1 0 0
0 2 2 2 1 3 1 2 2 0 8 6 2 0 1 0 0
2 3 0 2 0 0 0 1 1 2 0 5 1 3 1 0 0
0 2 2 2 2 2 0 0 2 0 0 4 2 0 1 1 3