25 16
39 39 37 37 37 37 37 37 37 37 37 37 37 37 37 37 37 37 37 37 37 37 37 37 37
39 41 38 38 38 38 38 38 38 38 38 38 38 38 38 38 38 38 38 38 38 38 38 38 38
39 41 0 0 0 0 0 0 0 0 0 0 0 0 0 0 0 0 0 0 0 0 0 0 0
39 41 0 0 54 54 0 0 0 0 0 0 0 16 19 22 25 28 0 0 0 0 0 0 0
39 41 0 3 52 52 0 0 3 0 0 0 3 17 20 23 26 29 0 0 0 10 11 12 0
39 41 0 0 52 52 0 0 0 0 0 0 0 18 21 24 27 30 0 0 3 13 14 15 0
39 41 0 0 52 52 0 0 10 11 12 0 0 0 33 31 33 0 0 0 0 0 7 9 0
39 41 0 0 0 0 3 0 13 14 15 0 0 34 31 32 31 35 0 0 0 8 6 0 0
39 41 0 0 0 0 0 0 0 7 9 0 0 45 47 47 47 53 0 0 0 0 5 0 0
39 41 0 0 0 0 0 0 0 5 0 0 3 0 47 47 47 51 0 0 0 0 4 0 0
39 41 0 0 0 0 0 0 0 4 0 0 0 0 50 47 47 47 47 47 51 0 0 0 0
39 41 0 0 10 11 12 0 54 54 54 54 0 0 0 50 47 47 47 47 47 51 0 0 0
39 41 0 0 13 14 15 0 52 52 52 52 53 0 0 0 0 0 50 47 47 47 47 47 47
39 41 0 0 8 6 0 0 52 52 52 52 0 0 3 0 0 0 0 50 47 47 47 47 47
39 41 0 0 0 4 0 3 0 0 0 0 0 0 0 0 0 0 0 0 0 0 0 0 0
39 39 39 39 39 39 39 39 39 39 39 39 39 39 39 39 39 39 39 39 39 39 39 39 39