25 16
0 0 0 37 37 37 37 37 37 37 37 37 37 37 37 37 37 37 37 37 37 37 37 37 37
0 0 0 36 36 36 36 36 36 36 36 36 36 36 36 36 36 36 36 36 36 36 36 36 36
0 0 0 38 38 38 38 38 38 38 38 38 38 38 38 38 38 38 38 38 38 38 38 38 38
39 41 0 0 0 0 0 0 0 0 0 0 0 16 19 22 25 28 0 0 0 0 0 0 0
39 41 0 3 0 0 0 0 3 0 0 0 3 17 20 23 26 29 0 0 0 0 0 0 0
39 41 0 0 0 0 0 0 0 0 0 0 0 18 21 24 27 30 0 0 3 0 0 0 0
39 41 0 0 0 0 0 0 10 11 12 0 0 0 33 31 33 0 0 0 0 0 0 0 0
39 41 0 0 0 0 3 0 13 14 15 0 0 34 31 32 31 35 0 0 0 0 0 0 0
39 41 0 0 0 0 0 0 0 7 9 0 0 0 42 0 42 0 0 0 0 0 0 0 3
39 41 0 0 0 0 0 0 0 5 0 0 3 0 0 0 0 0 0 0 0 0 0 0 0
39 41 0 0 0 0 0 0 0 4 0 0 0 0 0 0 0 0 0 10 11 12 0 0 0
39 41 0 0 10 11 12 0 0 0 0 0 0 0 0 0 0 0 0 13 14 15 0 0 0
39 41 0 0 13 14 15 0 0 0 0 0 0 0 0 0 3 0 0 0 7 9 0 0 0
39 41 0 0 8 6 0 0 0 0 0 0 0 0 3 0 0 0 0 8 6 0 0 0 0
39 41 0 0 0 4 0 0 0 0 0 0 0 0 0 0 0 0 0 0 4 0 0 0 0
39 41 0 0 0 0 0 0 0 0 0 3 0 0 0 0 0 0 0 0 0 0 0 0 3