17 12
27 27 27 27 27 27 27 27 27 27 27 27 27 27 27 27 27
27 20 20 20 20 20 20 20 20 20 20 20 20 20 20 20 27
27 20 20 20 20 20 20 20 20 20 20 20 20 20 20 20 27
27 20 20 0 0 0 0 0 0 0 0 0 0 0 20 20 27
27 20 20 0 0 0 0 0 0 0 0 0 0 0 20 20 27
27 20 20 0 22 25 5 25 21 0 0 0 0 0 20 20 27
27 20 20 0 24 1 1 1 23 0 0 0 0 0 20 20 27
27 20 20 0 0 0 0 0 0 0 0 0 0 0 20 20 27
27 20 20 0 0 0 0 0 0 0 0 0 0 0 20 20 27
27 20 20 0 0 0 0 0 0 0 0 0 0 0 20 20 27
27 20 20 0 0 0 0 0 0 0 0 0 0 0 20 20 27
27 20 20 0 0 0 0 17 17 0 0 0 0 0 20 20 27