17 12
12 12 12 6 14 14 14 14 14 14 14 14 14 6 12 12 12
12 12 12 6 14 5 5 14 14 14 5 5 26 6 12 12 12
12 12 12 6 13 13 13 13 13 13 13 13 13 6 12 12 12
12 12 12 6 0 16 17 0 0 0 0 0 4 6 12 12 12
12 12 12 6 0 0 0 0 0 0 0 0 9 6 12 12 12
12 12 12 6 0 0 0 0 0 0 0 0 0 6 12 12 12
12 12 12 6 18 19 19 19 0 0 0 0 0 6 12 12 12
12 12 12 6 21 23 25 22 0 0 0 0 0 6 12 12 12
12 12 12 6 0 24 0 0 0 0 0 0 0 6 12 12 12
12 12 12 6 0 0 0 0 0 0 0 0 0 6 12 12 12
12 12 12 6 0 0 0 0 10 0 0 0 0 6 12 12 12
12 12 12 6 7 7 7 7 11 7 7 7 7 6 12 12 12